111111111111111
1000C000000C001
100000000000001
10000000000P001
10E000000000001
111111111101111
111111111111111