111111111111111
1000C000E00C001
1100000000P0011
111111110111111
100000000000001
101111111111111
10000E000001111
111111111111111