11111111111111111111
1P00000000000100C001
1111111011111100C001
100000C01X0001000001
11111110100001111101
10000000000000000001
1X0X1111111111110X01
10E01000000X00C00111
11111111111111111111